0011001111000000000000000000000000000000000000000001111111111111111111111000000000000000000000001111
0011001111000000000000000000000000000000000000000001111111111111111111111000000000111111111100001111
0011001111000000000000000000000000000000000000000001111111111111111111111000000000111111111100001111
0000000111101000000000000000000000000000011111111000000000000000000000000000000000011111111110000111
0000110111101011111101111111111111111011111111100000111111111111111011111100000000011111111110000111
0001011111101011111101111101111111110000011111110000111111111111111111111100000000011111111110000111
0111011111101011111101111101111111111100011111111100011111111111111111111100000000011111111110000111
0000000000000000000020000000000000000002000000000000000000000000011111111100000000000000010000000111
0000000000000000000000000000000000000000000000000000000000000000011111111100000000000000010000000111
0001011111101011111121111111111111110000011111110000111111111111111111111100000000011111111110000111
0001011111101011111101111111111111110000011111110000111111111111111111111100000000011100000110000111
1111111111101011111101111111111111110000011111110000111111111111111111111100000000011101110110000111
0001011111101011111101111111111111110000011111110000000000000000000000000000000000011101110110000111
0001011111101011111101111111111111110000011111110000111111111111111111111100000000011101110110000111
0001011111111011111101111111111111110000011111110000111111111111111111111100000000011101110110000111
0001011111101011111101111111111111110000011111110000111111111111111111111100000000011100000000111111
0001011111101011111101111111111111110000011111110000111111111111111111111100000000011100000000111111
0001011111101011111101111111111111110000011111110000111111111111111111111100000000011100000000111111
0001011111101011111101111111111111110000011111110000111111111111111111111100000000011100000000111111
0001011111101011111101111111111111110000011111110000111111111111111111111100000000011100000000111111
0001011111101011111101111111111111110000011111110000111111111111111111111100000000011100000000111111
0001011111101011111101111111111111110000011111110000111111111111111111111100000000011100000000111111
0001011111101011111101111111111111110000011111110000111111111111111111111100000000011100000000111111
0001011111101011111101111111111111110000011111110000111111111111111111111100000000011100000000111111
0001011111101011111101111111111111110000011111110000111111111111111111111100000000011100000000111111
0001011111101011111101111111111111110000011111110000111111111111111111111100000000011100000000111111
0001011111101011111101111111111111110000011111110000111111111111111111111100000000011100000000111111
0001011111111111111111111111111111110000011111110000111111111111111111111100000000011100000000111111
0000000000000000000010000010000000001111100000001111000000000000000000000000000000000000000000000001
1111111111111111111111111111111111111111111111111111111111111111111111111111111111111111110000000003